%%%%%%%%%%%%%%%%%%%%%%%
%             %      P%
% %%%%%% %%%%%% %%%%% %
% %   % %     % %   % %
% % %%% % %%% % %%% % %
% %     % %   %     % %
% %%%%%%% % %%%%%%% %%
%         %         % %
%%%%%%%%%%%%%%%%%%%%%%%
%         %         % %
% %%%%%%% % %%%%%%% %%
% %     % %   %     % %
% % %%% % %%% % %%% % %
% %   % %     % %   % %
% %%%%%% %%%%%% %%%%% %
% .            %      %
%%%%%%%%%%%%%%%%%%%%%%%