%%%%%%%%%%%%%%%%%%%%%%%%%%%%%%%
%.%         %% G %   %%%%     %
% % %%%%%%% %%%%%% %%%%%%% %% %
%            %   %            %
%%%%%   %%%         % %   % %%%
% %%% %%%%% %%%%%%% %%% % %%%%%
%              P    %   %     %
%%%%%%%%%%%%%%%%%%%%%%%%%%%%%%%
