%%%%%%
%.   %
% %% %
% %% %
% P  %
% %%%%
%    %
%%%%%%
