%%%%%%%%%%%%%%%%%%%%
%                  %
%                  %
%        P         %
%                  %
%                . %
%%%%%%%%%%%%%%%%%%%%
