%%%%%%%%%
%       %
%%%% %% %
%   P   %
% %% %% %
% %.    %
%%%%%%%%%
